NO textures/north.xpm
SO textures/south.xpm
WE textures/west.xpm
EA textures/east.xpm

F 42,42,42
C 200,30,0

        1111111
        1000001        111
11111111100 001        1N1
10000000000 001        111
111111111111111
