NO textures/north_fuhrer.xpm
SO textures/south_fuhrer.xpm
WE textures/west_fuhrer.xpm
EA textures/east_fuhrer.xpm

F 220,100,2
C 225,30,0

        1111111
        1000001
111111111000001
1000000000000N1
111111111111111
