NO textures/north_fuhrer.xpm
SO textures/south_fuhrer.xpm
WE textures/west_fuhrer.xpm
EA textures/east_fuhrer.xpm

F 42,42,42
C 200,30,0

        1111111
        1000001
11111111100 001
10000000000E         1
111111111111111
