NO textures/north.xpm
SO textures/south.xpm
WE textures/west.xpm
EA textures/east.xpm

F 42,42,42
C 200,30,0

        1111111
       11000010111111111
11111110000011111111111
10000000000001111111111
111111111111111
111
1E1
111111111111111
111111111111111
111111111111111
111101111111111
111111111111111
111111111111111
111111111111111
111111111111111