NO textures/north.xpm
SO textures/south.xpm
WE textures/west.xpm
EA textures/east.xpm

F 220,100,2
C 225,30,0


111111
100001
10E001
100001
111111
111111
111111
