NO textures/north_fuhrer.xpm
SO textures/south_fuhrer.xpm
WE textures/west_fuhrer.xpm
EA textures/east_fuhrer.xpm

F 220,100,2
C 225,30,0

        1111111                          1        111
        1000010111111111                101
1111111110000011111111111                1
1000000000000N1111111111
111111111111111