NO textures/north_fuhrer.xpm
SO textures/south_fuhrer.xpm
WE textures/west_fuhrer.xpm
EA textures/east_fuhrer.xpm

F 220,100,2
C 225,30,0

11111111111111111111111
11000010111111111111111
11111110000011111111111
10000000000001111111111
11111111111111111111111
11
1E1
111111111111111
111111111111111
111111111111111
111101111111111
111111111111111
111111111111111
111111111111111
111111111111111